smoke has no description.

Hornets Nest
An Interactive Experience in Pest Removal by Jason Lautzenheiser
Release 1 / Serial number 130914 / Inform 7 build 6G60 (I6/v6.32 lib 6/12N) SD
Copyright © 2013, Jason Lautzenheiser.

Under the Tree
You are standing under the large shade tree in the front yard.  The tree provides a wonderous shade during the summer months that you take advantage of whenever you can.  However, now the as fall is in full swing and winter is approaching, the leaves are beginning to fall and pile up under the tree.  Now that the leaves are becoming sparse in the tree, you can now see a hornet's nest about ten feet up on a branch.  To the south is your ancient utility shed where you store all the essentials.  You can go west to get on your porch.

>x tre
You can't see any such thing.

* * *

>x tree
The large shade tree stands majestically in your front yard.  It is well over fifty feet tall and a hundred years old.  The trees branches spread over the front porch and shade the house well from the morning sun.  About ten feet up is the largest hornet's nest you've ever seen.

>x beehive
The beehive is the largest you've seen, bending the branch it's hanging from.

In the beehive are some bees.

* * *

>x tree
The large shade tree stands majestically in your front yard.  It is well over fifty feet tall and a hundred years old.  The trees branches spread over the front porch and shade the house well from the morning sun.  About ten feet up is the largest hornet's nest you've ever seen.

>x nest
You see a gigantic hornet's nest hanging from the branch of your shade tree.  It must have appeared overnight as you don't recall seeing it yesterday.

In the hornet's nest are some hornets.

* * *

>x tree
The large shade tree stands majestically in your front yard.  It is well over fifty feet tall and a hundred years old.  The trees branches spread over the front porch and shade the house well from the morning sun.  About ten feet up is the largest hornet's nest you've ever seen.

>s
In the Shed
Your utility shed stands was built back in the 1860s and is falling down around you, however it's close to the house, easy to get to and large enough to store just about anything you need around the yard.  In fact, there is probably over a hundred years of junk in here that you keep saying someday you'll clean out.

You can see a can of bug killer and a ladder here.

>n
Under the Tree
You are standing under the large shade tree in the front yard.  To the south is your ancient utility shed where you store all the essentials.

* * *

>s
In the Shed
Your utility shed stands was built back in the 1860s and is falling down around you, however it's close to the house, easy to get to and large enough to store just about anything you need around the yard.  In fact, there is probably over a hundred years of junk in here that you keep saying someday you'll clean out.

You can see a can of bug killer and a ladder here.

>take ladder
Taken.

* * *

>x tree
The large shade tree stands majestically in your front yard.  It is well over fifty feet tall and a hundred years old.  The trees branches spread over the front porch and shade the house well from the morning sun.  About ten feet up is the largest hornet's nest you've ever seen.

>exits
That's not a verb I recognize.

* * *

>x beess
You can't see any such thing.

>x bees
The bees look like normal honey bees, ones that aren't very happy, but normal ones.

>x self
As good-looking as ever.

>x me
As good-looking as ever.

>about
BeeHive was created in the fall of 2013 as an exercise.

BeeHive is copyright © 2013 by Jason Lautzenheiser (jlautz@sssnet.com or visit by blog at http://lautzofif.wordpress.com/). It may be distributed for free, but not sold or included in any for-profit collection without written permission from the author.

* * *

>showme bees
bees - thing
location: in the beehive , which is part of the shade tree in Under the Tree
plural-named, improper-named; unlit, inedible, portable
printed name: "bees"
printed plural name: none
indefinite article: "some"
description: "The bees look like normal honey bees, ones that aren't very happy, but normal ones."
initial appearance: "There are bees swarming around the hive."
bees condition: subdued

* * *

>s
Outside the Shed
Your utility shed was built back in the 1860s and is falling down, however it's close to the house, easy to get to and large enough to store just about anything you need around the yard.

>n
Under the Tree
You are standing under the large shade tree in the front yard.  The tree provides a wonderous shade that you take advantage of whenever you can.  However, there seems to be a hornet's nest that is disrupting your relaxation.  To the south is your ancient utility shed where you store all the essentials.  You can go west to get on your porch.

>s
In the Shed
Your utility shed stands was built back in the 1860s and is falling down around you, however it's close to the house, easy to get to and large enough to store just about anything you need around the yard.  In fact, there is probably over a hundred years of junk in here that you keep saying someday you'll clean out.

You can see a can of bug killer and a ladder here.

>n
On the Porch
The front porch is where you spend most of your evenings after work in the summer.  Sitting on the swing and drinking a beer.

>e
Under the Tree
You are standing under the large shade tree in the front yard.  To the south is your ancient utility shed where you store all the essentials.

>s
In the Shed
Your utility shed stands was built back in the 1860s and is falling down around you, however it's close to the house, easy to get to and large enough to store just about anything you need around the yard.  In fact, there is probably over a hundred years of junk in here that you keep saying someday you'll clean out.

You can see a spray can here.

>take can
Taken.

>x can
The can of bug killer has been laying in the shed for a number of years.

>shake
That's not a verb I recognize.

>shake can
That's not a verb I recognize.

>smile
That's not a verb I recognize.

>spray
That's not a verb I recognize.

* * *

>s
In the Shed
Your utility shed stands was built back in the 1860s and is falling down around you, however it's close to the house, easy to get to and large enough to store just about anything you need around the yard.  In fact, there is probably over a hundred years of junk in here that you keep saying someday you'll clean out.

You can see a can of bug killer and a ladder here.

>tak ladder
That's not a verb I recognize.

>n
Under the Tree
You are standing under the large shade tree in the front yard.  To the south is your ancient utility shed where you store all the essentials.

* * *

>n
Under the Tree
You are standing under the large shade tree in the front yard.  The tree provides a wonderous shade that you take advantage of whenever you can.  However, there seems to be a hornet's nest that is disrupting your relaxation.  To the south is your ancient utility shed where you store all the essentials.  You can go west to get on your porch.

>test spray
(Testing.)

>[1] s

Outside the Shed
Your utility shed was built back in the 1860s and is falling down, however it's close to the house, easy to get to and large enough to store just about anything you need around the yard.  

>[2] in

In the Shed
You're inside your shed.  You see piles and piles of junk. In fact, there is probably over a hundred years of junk in here that you keep saying someday you'll clean out.

You can see a can of bug killer and a ladder here.

>[3] take ladder
Taken.

>[4] take can
Taken.

>[5] out

Outside the Shed
Your utility shed was built back in the 1860s and is falling down, however it's close to the house, easy to get to and large enough to store just about anything you need around the yard.  

>[6] n

Under the Tree
You are standing under the large shade tree in the front yard.  The tree provides a wonderous shade that you take advantage of whenever you can.  However, there seems to be a hornet's nest that is disrupting your relaxation.  To the south is your ancient utility shed where you store all the essentials.  You can go west to get on your porch. 

>[7] lean ladder on tree
You lean the ladder against the tree, being careful not to bump the nest in the process.

>[8] u

Up the Tree
You are standing near the top of the ladder near the nest.  The hornets are beginning to become aware of your presence and starting to buzz your head.

>[9] spray
(the bug killer)
You are close enough now, there is no way you'll miss.  You'll have these doggone hornets out of your air in no time.  You shake the can one last time, more of a nervous habit than out of necessity, take careful aim.....

...You shake the can and look at it in horror.  Just a little spray dribbled out of the can....just enough to grab the hornets attention.  They have noticed you and are headed in your direction.

>[10] z
Time passes.

The hornets swarm around you aggressively, diving in and trying to penetrate through the wall of your flailing arms .  You jump out of the tree and run around screaming wildely.  For a few moments you don't even realize that after the hornets got you out of the tree, they went back to their nest.

Hiding outside the Shed
Your utility shed was built back in the 1860s and is falling down, however it's close to the house, easy to get to and large enough to store just about anything you need around the yard.  

Well that didn't work too well.  You throw the can away in disgust and as it bounces off  it hits square on the nozzle, which promptly breaks off and a long spray comes out until now the can is now truly empty.  As you look on in disbelief, a thought comes to you; hornets don't like smoke, why don't I try smoking them out.
>[11] z
Time passes.

From here you can hear the angry buzz of the hornets.

>z
Time passes.

You can see the hornets swarming as if looking for something to sting.

>l
Hiding outside the Shed
Your utility shed was built back in the 1860s and is falling down, however it's close to the house, easy to get to and large enough to store just about anything you need around the yard.  Stacked to one side of the shed is a pile of wood.

You can see a can of now empty bug killer here.

You must have really made them mad this time.

>x wood
You stacked this wood here years ago in the misguided thought that you would actually use the wood-burner in the house to save on heating costs in the winter.  Well here it still is, nicely stacked.

* * *

>s
Outside the Shed
Your utility shed was built back in the 1860s and is falling down, however it's close to the house, easy to get to and large enough to store just about anything you need around the yard.

>take can
Taken.

>shake can
You shake and shake listening to that little ball inside bounce on the sides of the can and there seems to be a little spray left.

>spray can
You shake the can and look at it in horror.  Enough of the spray came out, just to grab the bees attention.  They have noticed you and are headed in your direction.

* * *

>take can
Taken.

>n
On the Porch
The front porch is where you spend most of your evenings after work in the summer.  Sitting on the swing and drinking a beer.

* * *

>e
Under the Tree
You are standing under the large shade tree in the front yard.  To the south is your ancient utility shed where you store all the essentials.

>spray can
You shake the can and look at it in horror.  Enough of the spray came out, just to grab the hornets attention.  They have noticed you and are headed in your direction.

>x bees
You can't see any such thing.

>x hornets
Oh boy, you better move it.....they are flying every which way that looks chaotic yet orchestrated at the same time. It would be wise to move quickly, they are headed your way.

* * *

>take can
Taken.

>take ladder
Taken.

>n
Under the Tree
You are standing under the large shade tree in the front yard.  The tree provides a wonderous shade that you take advantage of whenever you can.  However, there seems to be a hornet's nest that is disrupting your relaxation.  To the south is your ancient utility shed where you store all the essentials.  You can go west to get on your porch.

>throw can at ladder
It would be difficult to throw at something you are yourself holding.

* * *

>s
Outside the Shed
Your utility shed was built back in the 1860s and is falling down, however it's close to the house, easy to get to and large enough to store just about anything you need around the yard.

>lean
That's not a verb I recognize.

>i
You are carrying nothing.

>take ladder
Taken.

>n
Under the Tree
You are standing under the large shade tree in the front yard.  To the south is your ancient utility shed where you store all the essentials.

>put ladder on tree
Putting things on the shade tree would achieve nothing.

* * *

>s
Outside the Shed
Your utility shed was built back in the 1860s and is falling down, however it's close to the house, easy to get to and large enough to store just about anything you need around the yard.

>take ladder
Taken.

* * *

>n
Under the Tree
You are standing under the large shade tree in the front yard.  To the south is your ancient utility shed where you store all the essentials.

>lean ladder on tre
I only understood you as far as wanting to lean the ladder.

>lean ladder on tree
I only understood you as far as wanting to lean the ladder.

* * *

>n
Under the Tree
You are standing under the large shade tree in the front yard.  To the south is your ancient utility shed where you store all the essentials.

>put ladder on tree
You lean the ladder against the tree, being careful not to bump the nest in the process.

>l
Under the Tree
You are standing under the large shade tree in the front yard.  To the south is your ancient utility shed where you store all the essentials. The ladder is leaning up against the tree.

>u
Up the Tree
You are standing near the top of the ladder near the nest.  The hornets are beginning to become aware of your presence and starting to buzz your head.

>d
Under the Tree
You are standing under the large shade tree in the front yard.  To the south is your ancient utility shed where you store all the essentials. The ladder is leaning up against the tree.

>s
In the Shed
Your utility shed stands was built back in the 1860s and is falling down around you, however it's close to the house, easy to get to and large enough to store just about anything you need around the yard.  In fact, there is probably over a hundred years of junk in here that you keep saying someday you'll clean out.

You can see a can of bug killer here.

>take can
Taken.

>n
Under the Tree
You are standing under the large shade tree in the front yard.  To the south is your ancient utility shed where you store all the essentials. The ladder is leaning up against the tree.

>u
Up the Tree
You are standing near the top of the ladder near the nest.  The hornets are beginning to become aware of your presence and starting to buzz your head.

>spray
(the bug killer)
You are close enough now, there is no way you'll miss.  You'll have these doggone hornets out of your air in no time.  You shake the can one last time, more of a nervous habit than out of necessity, take careful aim.....You shake the can and look at it in horror.  Enough of the spray came out, just to grab the hornets attention.  They have noticed you and are headed in your direction.

* * *

>take ladder
Taken.

>throw ladder at tree
You can't see any such thing.

>e
You can't go that way.

>n
Under the Tree
You are standing under the large shade tree in the front yard.  The tree provides a wonderous shade that you take advantage of whenever you can.  However, there seems to be a hornet's nest that is disrupting your relaxation.  To the south is your ancient utility shed where you store all the essentials.  You can go west to get on your porch.

>throw ladder at tree
You give the ladder a heave and if by magic it lands upright leaning against the tree.