Hornets' Nest
An Interactive Experience in Pest Removal by Jason Lautzenheiser
Release 1 / Serial number 160109 / Inform 7 build 6M62 (I6/v6.33 lib 6/12N) SD
ABOUT for more information

Copyright © 2015, Jason Lautzenheiser.

Under the Tree
You are standing under the large shade tree in the front yard.  The tree provides wondrous shade during the summer months that you take advantage of whenever you can.  However, now as fall is in full swing and winter is approaching, the leaves are beginning to fall and pile up under the tree.  The leaves are becoming sparse in the tree and you can see a hornet's nest about ten feet up on a branch.  To the south is your ancient utility shed where you store all the essentials.  You can go west to get on your porch.

>x tre
You can't see any such thing.

I beg your pardon?

>x tree
The large shade tree stands majestically in your front yard.  It is well over fifty feet tall and a hundred years old.  The trees branches spread over the front porch and shade the house well from the morning sun

>x hive
You can't see any such thing.

>x beehive
You can't see any such thing.

>x bees
You can't see any such thing.

* * *

>x tree
The large shade tree stands majestically in your front yard.  It is well over fifty feet tall and a hundred years old.  The tree branches spread over the front porch and shade the house from the morning sun.  Hanging from a branch is the largest hornet's nest you've ever seen.

>x beehive
The beehive is the largest you've seen, bending the branch it's hanging from.

In the beehive are some bees.

* * *

>x tree
The large shade tree stands majestically in your front yard.  It is well over fifty feet tall and a hundred years old.  The tree branches spread over the front porch and shade the house from the morning sun.  Hanging from a branch is the largest hornet's nest you've ever seen.

>x nest
You see a gigantic hornet's nest hanging from the branch of your shade tree.  It must have appeared overnight as you don't recall seeing it yesterday.

In the hornet's nest are some hornets.

>actions
Actions listing on.

>x next
You can't see any such thing.

>x nest
[examining the beehive]
The beehive is the largest you've seen, bending the branch it's hanging from.

In the beehive are some bees.

[examining the beehive - succeeded]

>rules
Rules tracing now switched on. Type "rules off" to switch it off again, or "rules all" to include even rules which do not apply.

>x b ees
You can't see any such thing.

>x bees
[examining the bees]
[Rule "standard examining rule" applies.]
The bees look like normal honey bees, ones that aren't very happy, but normal ones.

[Rule "examine directions rule" applies.]
[Rule "examine containers rule" applies.]
[Rule "examine supporters rule" applies.]
[Rule "examine devices rule" applies.]
[Rule "examine undescribed things rule" applies.]
[Rule "report other people examining rule" applies.]
[examining the bees - succeeded]

>x nest
[examining the beehive]
[Rule "standard examining rule" applies.]
The beehive is the largest you've seen, bending the branch it's hanging from.

[Rule "examine directions rule" applies.]
[Rule "examine containers rule" applies.]
In the beehive are some bees.

[Rule "examine supporters rule" applies.]
[Rule "examine devices rule" applies.]
[Rule "examine undescribed things rule" applies.]
[Rule "report other people examining rule" applies.]
[examining the beehive - succeeded]

* * *

>x nest
You see a gigantic hornet's nest hanging from the branch of your shade tree.  It must have appeared overnight as you don't recall seeing it yesterday.

In the hornet's nest are some hornets.

>x bees
The bees look like normal honey bees, ones that aren't very happy, but normal ones.

* * *

>x nest
You see a gigantic hornet's nest hanging from the branch of your shade tree.  It must have appeared overnight as you don't recall seeing it yesterday.

In the hornet's nest are some hornets.

>x hornets
The hornets are swarming around the nest, workers headed in and out, soldiers perched on the nest as if expecting a full frontal assault.

>s
Outside the Shed
Your utility shed was built back in the 1860s and is falling down, however it's close to the house, easy to get to and large enough to store just about anything you need around the yard.

>s
In the Shed
You're inside your shed.  You see piles and piles of junk. In fact, there is probably over a hundred years of junk in here that you keep saying someday you'll clean out.  There is a dirty window in the north wall that looks back towards your front yard.

You can see a can of bug killer, a ladder and a horsefly here.

>take can
Taken.

>n
Outside the Shed
Your utility shed was built back in the 1860s and is falling down, however it's close to the house, easy to get to and large enough to store just about anything you need around the yard.

>s
In the Shed
You're inside your shed.  You see piles and piles of junk. In fact, there is probably over a hundred years of junk in here that you keep saying someday you'll clean out.  There is a dirty window in the north wall that looks back towards your front yard.

You can see a ladder and a horsefly here.

>take ladder
Taken.

>n
Outside the Shed
Your utility shed was built back in the 1860s and is falling down, however it's close to the house, easy to get to and large enough to store just about anything you need around the yard.

>n
Under the Tree
You are standing under the large shade tree in the front yard.  The tree provides a wonderous shade that you take advantage of whenever you can.  However, there seems to be a hornet's nest that is disrupting your relaxation.  To the south is your ancient utility shed where you store all the essentials.  You can go west to get on your porch.

>climb ladder
You never were much of a tree climber, besides it wouldn't be pretty if the bees attack while you were trying to pull yourself up the tree.

>lead ladder
That's not a verb I recognize.

>lean ladder
You lean the ladder against thin air and it promptly leans all the way to the ground.

>lean ladder against tree
You lean the ladder against the tree, being careful not to bump the nest in the process.

>u
Up the Tree
You are standing near the top of the ladder near the nest.  The hornets are beginning to become aware of your presence and starting to buzz your head.

>spray
(the bug killer)
You are close enough now, there is no way you'll miss.  You'll have these doggone hornets out of your hair in no time.  You shake the can one last time, more of a nervous habit than out of necessity, take careful aim.....

...You shake the can and look at it in horror.  Just a little spray dribbled out of the can....just enough to grab the hornets attention.  They have noticed you and are headed in your direction.

>d
Under the Tree
You are standing under the large shade tree in the front yard.  The tree provides a wonderous shade that you take advantage of whenever you can.  However, there seems to be a hornet's nest that is disrupting your relaxation.  To the south is your ancient utility shed where you store all the essentials.  You can go west to get on your porch. Your ladder is leaning up against the tree.

As soon as walk back under the tree the hornets seem to take notice of you again.  The reform into a tight group and launch an attack.  You hastily retreat back to where you came.

Up the Tree
You are standing near the top of the ladder near the nest.  The hornets are beginning to become aware of your presence and starting to buzz your head.

The hornets swarm around you aggressively, diving in and trying to penetrate through the wall of your flailing arms .  You jump out of the tree and run around screaming wildely.  For a few moments you don't even realize that after the hornets got you out of the tree, they went back to their nest.

Hiding on the Porch
The front porch is where you spend most of your evenings after work in the summer.  Sitting on the swing and drinking a beer.

Well that didn't work too well.  You throw the can away in disgust and as it bounces off the porch floor it hits square on the nozzle, which promptly breaks off and a long spray comes out until now the can is now truly empty.  As you look on in disbelief, a thought comes to you; hornets don't like smoke, why don't I try smoking them out.

* * *

>x nest
You see a gigantic hornet's nest hanging from the branch of your shade tree.  It must have appeared overnight as you don't recall seeing it yesterday.

In the hornet's nest are some hornets.

>x nest
You see a gigantic hornet's nest hanging from the branch of your shade tree.  

In the hornet's nest are some hornets.

>x hornets
The hornets are swarming around the nest, workers headed in and out, soldiers perched on the nest as if expecting a full frontal assault.

>x house
Your century old farm house sits in the middle of your farm.  It's old, it's got it's problems....but it's home.

>x shed
The tool shed was built back in the 1860s and is falling down, however it's close to the house, easy to get to and large enough to store just about anything you need around the yard.

>s
Outside the Shed
Your utility shed was built back in the 1860s and is falling down, however it's close to the house, easy to get to and large enough to store just about anything you need around the yard.

>x pile
You can't see any such thing.

>x wood
You can't see any such thing.

>s
In the Shed
You're inside your shed.  You see piles and piles of junk. In fact, there is probably over a hundred years of junk in here that you keep saying someday you'll clean out.  There is a dirty window in the north wall that looks back towards your front yard and a shelf covered in junk just inside the doorway.

You can see a ladder and a horsefly here.

>x ladder
The aluminum step ladder your Dad gave you for a house warming gift when you moved in twenty years ago is still laying where you left it.....oh....twenty years ago.

>take ladder
Taken.

* * *

>n
Outside the Shed
Your utility shed was built back in the 1860s and is falling down, however it's close to the house, easy to get to and large enough to store just about anything you need around the yard.

>x ladder
The aluminum step ladder your Dad gave you for a house warming gift when you moved in twenty years ago.

>l
Outside the Shed
Your utility shed was built back in the 1860s and is falling down, however it's close to the house, easy to get to and large enough to store just about anything you need around the yard.

* * *

>x tree
The large shade tree stands majestically in your front yard.  It is well over fifty feet tall and a hundred years old.  The tree branches spread over the front porch and shade the house from the morning sun.  Hanging from a branch is the largest hornet's nest you've ever seen.

>s
Outside the Shed
Your utility shed was built back in the 1860s and is falling down.  However, it's close to the house, easy to get to and large enough to store just about anything you need around the yard.  Your large tree is to the north and to the northwest is the front porch of your house.  Stacked to one side of the shed is a woodpile.

>n
Under the Tree
You are standing under the large shade tree in the front yard.  To the south is your ancient utility shed where you store all the essentials.

>x hornets
The hornets are swarming around the nest, workers headed in and out, soldiers perched on the nest as if expecting a full frontal assault.

>showme hornets
hornets - thing
location: in the hornet's nest , which is part of the shade tree in Under the Tree
plural-named, improper-named; unlit, inedible, portable
printed name: "hornets"
printed plural name: none
indefinite article: "some"
description: "The hornets are swarming around the nest, workers headed in and out, soldiers perched on the nest as if expecting a full frontal assault.
"
initial appearance: none
hornets condition: swarming

* * *

>s
Outside the Shed
Your utility shed was built back in the 1860s and is falling down.  However, it's close to the house, easy to get to and large enough to store just about anything you need around the yard.  Your large tree is to the north and to the northwest is the front porch of your house.  Stacked to one side of the shed is a woodpile.

>take ladder
Taken.

>n
Under the Tree
You are standing under the large shade tree in the front yard.  To the south is your ancient utility shed where you store all the essentials. 

The large shade tree stands majestically in your front yard.  It is well over fifty feet tall and a hundred years old.  The trees branches spread over the front porch and shade the house well from the morning sun.  About ten feet up is the largest hornet's nest you've ever seen.

>lean ladder on tree
You lean the ladder against the tree, being careful not to bump the nest in the process.

>l
Under the Tree
You are standing under the large shade tree in the front yard.  To the south is your ancient utility shed where you store all the essentials. The ladder is leaning up against the tree.

The large shade tree stands majestically in your front yard.  It is well over fifty feet tall and a hundred years old.  The trees branches spread over the front porch and shade the house well from the morning sun.  About ten feet up is the largest hornet's nest you've ever seen. The ladder is leaning against the tree.

On the shade tree is a ladder.

* * *

>s
Outside the Shed
Your utility shed was built back in the 1860s and is falling down.  However, it's close to the house, easy to get to and large enough to store just about anything you need around the yard.  Your large tree is to the north and to the northwest is the front porch of your house.  Stacked to one side of the shed is a woodpile.

>x tree
The large shade tree stands majestically in your front yard.  It is well over fifty feet tall and a hundred years old.  The trees branches spread over the front porch and shade the house well from the morning sun.  About ten feet up is the largest hornet's nest you've ever seen.

>s
In the Shed
You're inside your shed.  You see piles and piles of junk. In fact, there is probably over a hundred years of junk in here that you keep saying someday you'll clean out.  There is a dirty window in the north wall that looks back towards your front yard and a shelf covered in junk just inside the doorway.  

You can see a ladder and a horsefly here.

>x tree
You look out the window and see the tree in front of your house.

>n
Outside the Shed
Your utility shed was built back in the 1860s and is falling down, however it's close to the house, easy to get to and large enough to store just about anything you need around the yard.

>x tree
The large shade tree stands majestically in your front yard.  It is well over fifty feet tall and a hundred years old.  The trees branches spread over the front porch and shade the house well from the morning sun.  About ten feet up is the largest hornet's nest you've ever seen.

* * *

>x tree
You look out the window and see the tree in front of your house.

>search shelf
As you rumage through the junk on the shelf, you notice a can of bug killer that must have been thrown up there years ago.

>take can
You can't reach the tree from here.

>take bug killer
You can't reach the tree from here.

* * *

>s
Outside the Shed
Your utility shed was built back in the 1860s and is falling down.  However, it's close to the house, easy to get to and large enough to store just about anything you need around the yard.  Your large tree is to the north and to the northwest is the front porch of your house.  Stacked to one side of the shed is a woodpile.

>s
In the Shed
You're inside your shed.  It is a complete mess.  There is a dirty window in the north wall that looks back towards your front yard and a shelf covered in junk just inside the doorway to the north.  Hanging on the wall near the back is a handsaw.

You can see a ladder here.

>take all
ladder: Taken.
hand saw: Taken.

>n
Outside the Shed
Your utility shed was built back in the 1860s and is falling down.  However, it's close to the house, easy to get to and large enough to store just about anything you need around the yard.  Your large tree is to the north and to the northwest is the front porch of your house.  Stacked to one side of the shed is a woodpile.

I beg your pardon?

>n
Under the Tree
You are standing under the large shade tree in the front yard.  The tree provides wondrous shade during the summer months that you take advantage of whenever you can.  However, now as fall is in full swing and winter is approaching, the leaves are beginning to fall and pile up under the tree.  The leaves are becoming sparse in the tree and you can see a hornet's nest about ten feet up on a branch.  To the south is your ancient utility shed where you store all the essentials.  You can go west to get on your porch.

>lean ladder on tree
You lean the ladder against the tree, being careful not to bump the nest in the process.

>l
Under the Tree
You are standing under the large shade tree in the front yard.  The tree provides wondrous shade during the summer months that you take advantage of whenever you can.  However, now as fall is in full swing and winter is approaching, the leaves are beginning to fall and pile up under the tree.  The leaves are becoming sparse in the tree and you can see a hornet's nest about ten feet up on a branch.  To the south is your ancient utility shed where you store all the essentials.  You can go west to get on your porch.  Your ladder is leaning up against the tree.

>x tree
The large shade tree stands majestically in your front yard.  It is well over fifty feet tall and a hundred years old.  The tree branches spread over the front porch and shade the house from the morning sun.  Hanging from a branch is the largest hornet's nest you've ever seen. The ladder is leaning against the tree.

>cut branch with saw
I only understood you as far as wanting to cut the shade tree.

>u
Up the Tree
You are standing near the top of the ladder near the nest.  The hornets are beginning to become aware of your presence and starting to buzz your head.  The only way is down.

>cut branch with saw
I only understood you as far as wanting to cut the shade tree.

>saw branch
You take the hand saw and begin to cut through the branch that the hornet's nest is hanging from.  After a moment the branch cracks and falls to the ground taking the nest with it.  You start to raise your arms in triumph, but then remembering you are standing on a ladder, you think better of it and just grin happily to yourself.

As the nest hits the ground, it bursts into pieces and the hornets scatter in all directions.......only to regroup high up in the tree where they hover for a moment, then as if shot from a pistol, head in your direction.

* * *

>x tree
The large shade tree stands majestically in your front yard.  It is well over fifty feet tall and a hundred years old.  The tree branches spread over the front porch and shade the house from the morning sun.  Hanging from a branch is the largest hornet's nest you've ever seen.

>exits
That's not a verb I recognize.

* * *

>l
Under the Tree
You are standing under the large shade tree in the front yard.  The tree provides a wonderous shade during the summer months that you take advantage of whenever you can.  However, now as fall is in full swing and winter is approaching, the leaves are beginning to fall and pile up under the tree.  The leaves are becoming sparse in the tree and you can see a hornet's nest about ten feet up on a branch.  To the south is your ancient utility shed where you store all the essentials.  You can go west to get on your porch. Your ladder is leaning up against the tree.

On the shade tree is a The ladder is leaning against the tree.

You can also see a small pile of flaming twigs here.

The hornets swarm around you aggressively, diving in and trying to penetrate through the wall of your flailing arms .  You run around screaming wildely.  For a few moments you don't even realize that after the hornets got you away from the tree, they went back to their nest.

As they swarm around your head, you notice there is something different about them....you swear they are wearing gas masks.

Hiding outside the Shed
Your utility shed was built back in the 1860s and is falling down, however it's close to the house, easy to get to and large enough to store just about anything you need around the yard.

* * *

I beg your pardon?

>;
That's not a verb I recognize.

>l
Under the Tree
You are standing under the large shade tree in the front yard.  The tree provides a wonderous shade during the summer months that you take advantage of whenever you can.  However, now as fall is in full swing and winter is approaching, the leaves are beginning to fall and pile up under the tree.  The leaves are becoming sparse in the tree and you can see a hornet's nest about ten feet up on a branch.  To the south is your ancient utility shed where you store all the essentials.  You can go west to get on your porch.

>x lader
You can't see any such thing.

>x ladder
You can't see any such thing.

>i
You're holding some leaves and a can of bug killer. You're wearing reading glasses, t-shirt, jean shorts and baseball cap.

>l
Under the Tree
You are standing under the large shade tree in the front yard.  The tree provides a wonderous shade during the summer months that you take advantage of whenever you can.  However, now as fall is in full swing and winter is approaching, the leaves are beginning to fall and pile up under the tree.  The leaves are becoming sparse in the tree and you can see a hornet's nest about ten feet up on a branch.  To the south is your ancient utility shed where you store all the essentials.  You can go west to get on your porch.

>showme ladder
ladder - thing
location: the shade tree in Under the Tree
singular-named, improper-named; unlit, inedible, portable, handled, listed when worn, listed when carried, not empty-listed, found, impervious
printed name: "ladder"
printed plural name: none
indefinite article: none
description: "The aluminum step ladder your Dad gave you for a house warming gift when you moved in twenty years ago is still laying where you left it.....oh....twenty years ago."
initial appearance: none
inventory listing: none
flame-state: new

* * *

>x tree
The large shade tree stands majestically in your front yard.  It is well over fifty feet tall and a hundred years old.  The tree branches spread over the front porch and shade the house from the morning sun.  Hanging from a branch is the largest hornet's nest you've ever seen.

>climb tree
You never were much of a tree climber, besides it wouldn't be pretty if the bees attack while you were trying to pull yourself up the tree.

>jump
You jump on the spot.

>l
Under the Tree
You are standing under the large shade tree in the front yard.  The tree provides wonderous shade during the summer months that you take advantage of whenever you can.  However, now as fall is in full swing and winter is approaching, the leaves are beginning to fall and pile up under the tree.  The leaves are becoming sparse in the tree and you can see a hornet's nest about ten feet up on a branch.  To the south is your ancient utility shed where you store all the essentials.  You can go west to get on your porch.  .

>xyzzy
You face the tree and wave your fingers at the nest while chanting "xyzzy, xyzzy, xyzzy ...." Nothing happens.

>.
That's not a verb I recognize.

>l
Under the Tree
You are standing under the large shade tree in the front yard.  The tree provides wonderous shade during the summer months that you take advantage of whenever you can.  However, now as fall is in full swing and winter is approaching, the leaves are beginning to fall and pile up under the tree.  The leaves are becoming sparse in the tree and you can see a hornet's nest about ten feet up on a branch.  To the south is your ancient utility shed where you store all the essentials.  You can go west to get on your porch.  .

>yell
That's not a verb I recognize.

>shout
I didn't understand that sentence.

>s
Outside the Shed
Your utility shed was built back in the 1860s and is falling down, however it's close to the house, easy to get to and large enough to store just about anything you need around the yard.

>in
In the Shed
You're inside your shed.  You see piles and piles of junk. In fact, there is probably over a hundred years of junk in here that you keep saying someday you'll clean out.  There is a dirty window in the north wall that looks back towards your front yard and a shelf covered in junk just inside the doorway.  

You can see a ladder here.

>search junk
You can't see any such thing.

>x window
The window is covered in cobwebs and dust.  It doesn't look like it's been cleaned for decades, if ever.  In the corner of the window is a large horsefly, buzzing up against the window trying to get out.

* * *

>s
Outside the Shed
Your utility shed was built back in the 1860s and is falling down.  However, it's close to the house, easy to get to and large enough to store just about anything you need around the yard.  Your large tree is to the north and to the northwest is the front porch of your house.  Stacked to one side of the shed is a woodpile.

* * *

>s
In the Shed
You're inside your shed.  It is a complete mess.  There is a dirty window in the north wall that looks back towards your front yard and a shelf covered in junk just inside the doorway to the north.  Hanging on the wall near the back is a handsaw.

You can see a ladder here.

>search
(In the Shed)
As you rummage through the junk on the shelf, you notice a can of bug spray that must have been thrown up there years ago.

>l
In the Shed
You're inside your shed.  It is a complete mess.  There is a dirty window in the north wall that looks back towards your front yard and a shelf covered in junk just inside the doorway to the north.  On the shelf is a can of bug killer.  Hanging on the wall near the back is a handsaw.

You can see a ladder here.

You notice a fly walking up the window.

* * *

>puzzles
Puzzles in process: None.
Puzzles not completed: spraying the nest with bug spray, using heavy smoke to remove the hornets, cutting the branch the nest is on out of the tree, blowing up the can of spray, hitting the nest with the ladder and using bug spray as flamethrower.
Active puzzles: None.
Completed puzzles: None.
Puzzles now impossible: None.
You have completed 0 puzzles.
You currently have 0 puzzles that are running.

>s
Outside the Shed
Your utility shed was built back in the 1860s and is falling down.  However, it's close to the house, easy to get to and large enough to store just about anything you need around the yard.  Your large tree is to the north and to the northwest is the front porch of your house.  Stacked to one side of the shed is a woodpile.

* * *

>take all
ladder: Taken.
hand saw: Taken.

>search
(In the Shed)
As you rummage through the junk on the shelf, you notice a can of bug killer that must have been thrown up there years ago.

A sudden silence startles you only to be interrupted by the fly in the window again.

>take all
bug killer: Taken.
hand saw: You already have that.

>l
In the Shed
You're inside your shed.  It is a complete mess.  There is a dirty window in the north wall that looks back towards your front yard and a shelf covered in junk just inside the doorway to the north.  

A fly buzzes past your nose, just to circle around and fly right back into the window.

>catch fly
You spend several minutes trying to get your hands on the fly.  It is only after it gets hung up in some cobwebs that you are finally able to catch it.  You grab it holding on by it's wings to keep it from moving around too much.

>n
Outside the Shed
Your utility shed was built back in the 1860s and is falling down.  However it's close to the house, easy to get to and large enough to store just about anything you need around the yard.  Your large tree is to the north and to the northwest is the front porch of your house.  Stacked to one side of the shed is a woodpile.

>put fly in web
You toss the fly into the web and the spider instantly pounces on it and begins to wrap it up.  When it's done wrapping, it drags the fly off the web and underneath the wood pile.

>take wood
You brush the web aside and take a handful of the dry wood.

>n
Under the Tree
You are standing under the large shade tree in the front yard.  The tree provides wonderous shade during the summer months that you take advantage of whenever you can.  However, now as fall is in full swing and winter is approaching, the leaves are beginning to fall and pile up under the tree.  The leaves are becoming sparse in the tree and you can see a hornet's nest about ten feet up on a branch.  To the south is your ancient utility shed where you store all the essentials.  You can go west to get on your porch.

>lean ladder on tree
You lean the ladder against the tree, being careful not to bump the nest in the process.

>u
Up the Tree
You are standing near the top of the ladder near the nest.  The hornets are beginning to become aware of your presence and starting to buzz your head.  The only way is down.

>spray nest
You are close enough now, there is no way you'll miss.  You'll have these damn hornets out of your hair in no time.  You shake the can one last time, more of a nervous habit than out of necessity, take careful aim.....and spray....

...you shake the can and look at it in horror as just a little spray dribbles out ....just enough to grab the hornets" attention and they begin to mass an attack.

>l
Up the Tree
You are standing near the top of the ladder near the nest.  The hornets are beginning to become aware of your presence and starting to buzz your head.  The only way is down.

The hornets swarm around you aggressively, diving in and trying to penetrate through the wall of your flailing arms.  You jump out of the tree and run around screaming wildly.

Hiding in the Shed
You're inside your shed.  It is a complete mess.  There is a dirty window in the north wall that looks back towards your front yard and a shelf covered in junk just inside the doorway to the north.  

Well that didn't work too well.  You throw the can away in disgust and as it bounces off the wall it hits square on the nozzle, which promptly breaks off and a long spray comes out until now the can is now truly empty.

As you look on in disbelief, a thought comes to you; hornets don't like smoke, why don't you try smoking them out.

>n
Outside the Shed
Your utility shed was built back in the 1860s and is falling down.  However it's close to the house, easy to get to and large enough to store just about anything you need around the yard.  Your large tree is to the north and to the northwest is the front porch of your house.  Stacked to one side of the shed is a woodpile. 

From here you can hear the angry buzz of the hornets.

>n
Under the Tree
You are standing under the large shade tree in the front yard.  The tree provides wonderous shade during the summer months that you take advantage of whenever you can.  However, now as fall is in full swing and winter is approaching, the leaves are beginning to fall and pile up under the tree.  The leaves are becoming sparse in the tree and you can see a hornet's nest about ten feet up on a branch.  To the south is your ancient utility shed where you store all the essentials.  You can go west to get on your porch.  Your ladder is leaning up against the tree.

As soon as walk back under the tree the hornets seem to take notice of you again.  The reform into a tight group and launch an attack.  You hastily retreat back to where you came.

Outside the Shed
Your utility shed was built back in the 1860s and is falling down.  However it's close to the house, easy to get to and large enough to store just about anything you need around the yard.  Your large tree is to the north and to the northwest is the front porch of your house.  Stacked to one side of the shed is a woodpile. 

You can see the hornets swarming as if looking for something to sting.

>n
Under the Tree
You are standing under the large shade tree in the front yard.  The tree provides wonderous shade during the summer months that you take advantage of whenever you can.  However, now as fall is in full swing and winter is approaching, the leaves are beginning to fall and pile up under the tree.  The leaves are becoming sparse in the tree and you can see a hornet's nest about ten feet up on a branch.  To the south is your ancient utility shed where you store all the essentials.  You can go west to get on your porch.  Your ladder is leaning up against the tree.

As soon as walk back under the tree the hornets seem to take notice of you again.  The reform into a tight group and launch an attack.  You hastily retreat back to where you came.

Outside the Shed
Your utility shed was built back in the 1860s and is falling down.  However it's close to the house, easy to get to and large enough to store just about anything you need around the yard.  Your large tree is to the north and to the northwest is the front porch of your house.  Stacked to one side of the shed is a woodpile. 

You must have really made them mad this time.

Hornets are no longer aggressive.

>n
Under the Tree
You are standing under the large shade tree in the front yard.  The tree provides wonderous shade during the summer months that you take advantage of whenever you can.  However, now as fall is in full swing and winter is approaching, the leaves are beginning to fall and pile up under the tree.  The leaves are becoming sparse in the tree and you can see a hornet's nest about ten feet up on a branch.  To the south is your ancient utility shed where you store all the essentials.  You can go west to get on your porch.  Your ladder is leaning up against the tree.

>climb ladder
You climb as quietly as possible up the ladder until you are just a few feet away from the nest.  The hornets didn't see you coming, but now a few start to buzz around your head.

Up the Tree
You are standing near the top of the ladder near the nest.  The hornets are beginning to become aware of your presence and starting to buzz your head.  The only way is down.

>cut tree
You take the hand saw and begin to cut through the branch that the hornet's nest is hanging from.  After a moment the branch cracks and falls to the ground taking the nest with it.  You start to raise your arms in triumph, but then remembering you are standing on a ladder, you think better of it and just grin happily to yourself.

As the nest hits the ground, it bursts into pieces and the hornets scatter in all directions.......only to regroup high up in the tree where they hover for a moment, then as if shot from a pistol, head in your direction.

>l
Up the Tree
You are standing near the top of the ladder near the nest.  The hornets are beginning to become aware of your presence and starting to buzz your head.  The only way is down.

The hornets swarm around you aggressively, diving in and trying to penetrate through the wall of your flailing arms.  You jump out of the tree and run around screaming wildly.

Hiding on the Porch
The front porch is where you spend most of your evenings after work in the summer, sitting on the porch swing and drinking a beer.  To the east right off the porch is the large tree and to the southeast is your shed.

You can see a shovel here.

Well that didn't work too well.  
As you look on in disbelief, a thought comes to you; hornets don't like smoke, why don't you try smoking them out.

>z
Time passes.

Occassionally a hornet seems to locate you.  It buzzes your head and you manage to swat it away before it does much damage.  It flys back towards the nest....you hope it doesn't bring back friends.

>z
Time passes.

You can see the hornets swarming as if looking for something to sting.

>z
Time passes.

From here you can hear the angry buzz of the hornets.

Hornets are no longer aggressive.

>z
Time passes.

>z
Time passes.

>n
You can't go that way.

From here, you can go southeast and east.

>l
Hiding on the Porch
The front porch is where you spend most of your evenings after work in the summer, sitting on the porch swing and drinking a beer.  To the east right off the porch is the large tree and to the southeast is your shed.

You can see a shovel here.

>e
Under the Tree
You are standing under the large shade tree in the front yard.  The tree provides wonderous shade during the summer months that you take advantage of whenever you can.  However, now as fall is in full swing and winter is approaching, the leaves are beginning to fall and pile up under the tree.  The leaves are becoming sparse in the tree and you can see a hornet's nest about ten feet up on a branch.  To the south is your ancient utility shed where you store all the essentials.  You can go west to get on your porch.  Your ladder is leaning up against the tree and  thebranch you just cut is laying on the ground.

>drop wood
Dropped.

>start fire with glasses
That's not a verb I recognize.

>burn wood with glasses
You take off your glasses and hold them at just the right angle so the sunlight makes a pinpoint on the twigs.    After a few moments a small stream of smoke rises from the twigs and then suddenly a flame appears.

>take leaves
You gather up a handful of leaves, but there are still plenty left to clean up.

>put leaves on fire
You toss the leaves onto the fire and the smoke begins to build until a dark gray cloud begins to lift from the ground up into the tree.

As the smoke rises it slowly begins to engulf the nest.  At first the hornets look confused as they their activity increases slightly, then suddenly they all retreat back into the nest.  Now the smoke is so heavy that you can't make out the nest at all.  You are feeling a little bit proud of yourself as you figure this will be the end of them all.

What is that noise?  You hear a faint buzz coming from the tree.  Looking up, the smoke begins to clear and you see a mass of hornets around the entrance to the nest.  Just as you see them, they see you and attack.

As they begin to swarm around your head, you notice there is something different about them.... they are now wearing minature gas masks.

The hornets swarm around you aggressively, diving in and trying to penetrate through the wall of your flailing arms.  You run around screaming wildly.

Hiding on the Porch
The front porch is where you spend most of your evenings after work in the summer, sitting on the porch swing and drinking a beer.  To the east right off the porch is the large tree and to the southeast is your shed.

You can see a shovel here.

>puzzles
fire-the-missle is not completed.
spray-the-nest is completed.
build-a-fire is completed.
smoke-the-nest is completed.
cut-the-branch is completed.
The last completed puzzle is smoke-the-nest.
Not completed: 1.
Active: 0.
Running: 0.

>e
Under the Tree
You are standing under the large shade tree in the front yard.  The tree provides wonderous shade during the summer months that you take advantage of whenever you can.  However, now as fall is in full swing and winter is approaching, the leaves are beginning to fall and pile up under the tree.  The leaves are becoming sparse in the tree and you can see a hornet's nest about ten feet up on a branch.  To the south is your ancient utility shed where you store all the essentials.  You can go west to get on your porch.  Your ladder is leaning up against the tree and  thebranch you just cut is laying on the ground.

You can see a small pile of flaming twigs here.

As soon as walk back under the tree the hornets seem to take notice of you again.  The reform into a tight group and launch an attack.  You hastily retreat back to where you came.

On the Porch
The front porch is where you spend most of your evenings after work in the summer, sitting on the porch swing and drinking a beer.  To the east right off the porch is the large tree and to the southeast is your shed.

You can see a shovel here.

You must have really made them mad this time.

>e
Under the Tree
You are standing under the large shade tree in the front yard.  The tree provides wonderous shade during the summer months that you take advantage of whenever you can.  However, now as fall is in full swing and winter is approaching, the leaves are beginning to fall and pile up under the tree.  The leaves are becoming sparse in the tree and you can see a hornet's nest about ten feet up on a branch.  To the south is your ancient utility shed where you store all the essentials.  You can go west to get on your porch.  Your ladder is leaning up against the tree and  thebranch you just cut is laying on the ground.

You can see a small pile of flaming twigs here.

As soon as walk back under the tree the hornets seem to take notice of you again.  The reform into a tight group and launch an attack.  You hastily retreat back to where you came.

On the Porch
The front porch is where you spend most of your evenings after work in the summer, sitting on the porch swing and drinking a beer.  To the east right off the porch is the large tree and to the southeast is your shed.

You can see a shovel here.

Occassionally a hornet seems to locate you.  It buzzes your head and you manage to swat it away before it does much damage.  It flys back towards the nest....you hope it doesn't bring back friends.

>e
Under the Tree
You are standing under the large shade tree in the front yard.  The tree provides wonderous shade during the summer months that you take advantage of whenever you can.  However, now as fall is in full swing and winter is approaching, the leaves are beginning to fall and pile up under the tree.  The leaves are becoming sparse in the tree and you can see a hornet's nest about ten feet up on a branch.  To the south is your ancient utility shed where you store all the essentials.  You can go west to get on your porch.  Your ladder is leaning up against the tree and  thebranch you just cut is laying on the ground.

You can see a small pile of flaming twigs here.

As soon as walk back under the tree the hornets seem to take notice of you again.  The reform into a tight group and launch an attack.  You hastily retreat back to where you came.

On the Porch
The front porch is where you spend most of your evenings after work in the summer, sitting on the porch swing and drinking a beer.  To the east right off the porch is the large tree and to the southeast is your shed.

You can see a shovel here.

You can see the hornets swarming as if looking for something to sting.

Hornets are no longer aggressive.

>e
Under the Tree
You are standing under the large shade tree in the front yard.  The tree provides wonderous shade during the summer months that you take advantage of whenever you can.  However, now as fall is in full swing and winter is approaching, the leaves are beginning to fall and pile up under the tree.  The leaves are becoming sparse in the tree and you can see a hornet's nest about ten feet up on a branch.  To the south is your ancient utility shed where you store all the essentials.  You can go west to get on your porch.  Your ladder is leaning up against the tree and  thebranch you just cut is laying on the ground.

You can see a small pile of flaming twigs here.

>put can on fire
You can't see any such thing.

>i
You are carrying:
  a hand saw
  reading glasses (being worn)
  t-shirt (being worn)
  jean shorts (being worn)
  baseball cap (being worn)

>s
Outside the Shed
Your utility shed was built back in the 1860s and is falling down.  However it's close to the house, easy to get to and large enough to store just about anything you need around the yard.  Your large tree is to the north and to the northwest is the front porch of your house.  Stacked to one side of the shed is a woodpile.

>s
In the Shed
You're inside your shed.  It is a complete mess.  There is a dirty window in the north wall that looks back towards your front yard and a shelf covered in junk just inside the doorway to the north.  

You can see a can of now empty bug killer here.

>take can
Taken.

>n
Outside the Shed
Your utility shed was built back in the 1860s and is falling down.  However it's close to the house, easy to get to and large enough to store just about anything you need around the yard.  Your large tree is to the north and to the northwest is the front porch of your house.  Stacked to one side of the shed is a woodpile.

>n
Under the Tree
You are standing under the large shade tree in the front yard.  The tree provides wonderous shade during the summer months that you take advantage of whenever you can.  However, now as fall is in full swing and winter is approaching, the leaves are beginning to fall and pile up under the tree.  The leaves are becoming sparse in the tree and you can see a hornet's nest about ten feet up on a branch.  To the south is your ancient utility shed where you store all the essentials.  You can go west to get on your porch.  Your ladder is leaning up against the tree and  thebranch you just cut is laying on the ground.

You can see a small pile of flaming twigs here.

>put can on fire
The can sits in the fire for a few moments and then it starts to turn a hot red as it heats up.  As the sides of the can start to bulge out at the center you quickly decide it's time to hide behind the tree.  Just as you retreat behind the tree you hear a large explosion and you hit the ground.  You hear a whistle as the exploded can flys towards the nest hitting it right in the bottom, plugging up the entrance to the nest.

    *** Here ends the intro to Hornet's Nest.  I hope you enjoyed this introduction to this piece.  I plan to add more ways to try and achieve your goal of removing the nest from the tree.   ***

In that game you scored 0 out of a possible 0, in 45 turns.

Would you like to RESTART, RESTORE a saved game, QUIT or UNDO the last command?